WWWWWWWWWWWWWWW
WPPPPPPPPPPPPPW
WPWWWWWPWWWWWPW
WPPPPPBBBPPPPPW
WPPPPPBBBPPPPPW
WBWWWWWPWWWWWBW
WBWPPPPBPPPPWBW
WBBPBPWPWPBPBBW
WBWPPPPBPPPPWBW
WBWWWWWPWWWWWBW
WPPPPPBBBPPPPPW
WPPPPPBBBPPPPPW
WPWWWWWPWWWWWPW
WPPPPPPPPPPPPPW
WWWWWWWWWWWWWWW