WWWWWWWWWWWWWWW
WPPPPPPPPPPPPPW
WPWPWPWPWPWPWPW
WPPPPPPPPPPPPPW
WPWPWPWPWPWPWPW
WPPPPPPPPPPPPPW
WPWPWPWPWPWPWPW
WPPPPPPPPPPPPPW
WPWPWPWPWPWPWPW
WPPPPPPPPPPPPPW
WPWPWPWPWPWPWPW
WPPPPPPPPPPPPPW
WPWPWPWPWPWPWPW
WPPPPPPPPPPPPPW
WWWWWWWWWWWWWWW