WWWWWWWWWWWWWWW
WPPBPPPPPBBPPPW
WPWPWPWPWBWPWPW
WPPBBBBBPPBPPPW
WPWPWPWPWPWPWBW
WBPBBPPPPPPPPBW
WPWPWBWBWPWPWPW
WPPBPBPPPPPBPPW
WPWBWBWPWPWPWPW
WBPPPBPBBPBPPBW
WPWBWBWPWBWPWPW
WPPBPPPBPBPBPBW
WPWPWPWBWPWBWPW
WPBPPPBBBBPPPPW
WWWWWWWWWWWWWWW
