WWWWWWWWWWWWWWW
WPPPPPPPPPPPPPW
WWWBWWBBWWBWWPW
WPPPPPPPPPPPWPW
WPWWWBWWWBWPBPW
WPBPPPPPPPWPWPW
WPWPWWBBBPWPWPW
WPBPBPBWBPBPBPW
WPWPWPBBBWWPWPW
WPWPWPPPPPPPBPW
WPBPWBWWWBWWWPW
WPWPPPPPPPPPPPW
WPWWBWWBBWWBWWW
WPPPPPPPPPPPPPW
WWWWWWWWWWWWWWW